12 10
##########
#  S     #
#     #  #
#   G #  #
#   ###  #
#        #
#        #
#        #
#        #
#        #
#        #
##########